111111111
100000001
100000001
11001C101
1P0100001
11001E101
100011101
111111111