1111111111111111111111111111111111
101D00000001111000E000000000000001
1PD000000C00C000010000000000000001
1010010010101010000001000000010111
1000010010101010000001000000010111
1000010010101010000001000000010111
1010010010101010000001000000010111
10D001001D101010D00001000000010111
1000010010101010000001000000010111
1010010010101010000001000000010111
1111111111111111111111111111111111